Detector,Profile,File,Threshold,Score,TP,TN,FP,FN,Total_Count
ARTime,reward_low_FP_rate,realTweets/Twitter_volume_AMZN.csv,0.317585,1.966628495776447,5,13494,7,1575,15081
ARTime,reward_low_FP_rate,realTweets/Twitter_volume_PFE.csv,0.317585,1.6867559726816772,5,13510,10,1583,15108
ARTime,reward_low_FP_rate,realTweets/Twitter_volume_KO.csv,0.317585,1.8952443725910728,4,13511,3,1583,15101
ARTime,reward_low_FP_rate,realTweets/Twitter_volume_AAPL.csv,0.317585,2.266382386012909,7,13556,8,1581,15152
ARTime,reward_low_FP_rate,realTweets/Twitter_volume_CVS.csv,0.317585,0.9580854899903284,8,13569,8,1518,15103
ARTime,reward_low_FP_rate,realTweets/Twitter_volume_CRM.csv,0.317585,1.5507276584285576,5,13554,5,1588,15152
ARTime,reward_low_FP_rate,realTweets/Twitter_volume_FB.csv,0.317585,0.6642437201314491,3,13496,5,1579,15083
ARTime,reward_low_FP_rate,realTweets/Twitter_volume_GOOG.csv,0.317585,0.3058998351460087,6,13650,10,1426,15092
ARTime,reward_low_FP_rate,realTweets/Twitter_volume_IBM.csv,0.317585,-0.21197286075456678,4,13544,9,1586,15143
ARTime,reward_low_FP_rate,realTweets/Twitter_volume_UPS.csv,0.317585,2.169711079601624,10,13521,10,1575,15116
ARTime,reward_low_FP_rate,realKnownCause/ec2_request_latency_system_failure.csv,0.317585,0.9678570007805122,4,3078,4,342,3428
ARTime,reward_low_FP_rate,realKnownCause/rogue_agent_key_hold.csv,0.317585,-2.050891492994684,1,1403,7,189,1600
ARTime,reward_low_FP_rate,realKnownCause/cpu_utilization_asg_misconfiguration.csv,0.317585,-1.4674703318594533,4,15790,11,1495,17300
ARTime,reward_low_FP_rate,realKnownCause/machine_temperature_system_failure.csv,0.317585,1.5184273798792873,9,19667,10,2259,21945
ARTime,reward_low_FP_rate,realKnownCause/rogue_agent_key_updown.csv,0.317585,-3.1353018320935964,0,4028,7,530,4565
ARTime,reward_low_FP_rate,realKnownCause/ambient_temperature_system_failure.csv,0.317585,1.5477451079123843,2,5790,1,724,6517
ARTime,reward_low_FP_rate,realKnownCause/nyc_taxi.csv,0.317585,3.445210013719179,7,8532,3,1028,9570
ARTime,reward_low_FP_rate,artificialWithAnomaly/art_increase_spike_density.csv,0.317585,0.846035950698122,2,3025,0,401,3428
ARTime,reward_low_FP_rate,artificialWithAnomaly/art_daily_flatmiddle.csv,0.317585,0.7544410985057226,1,3024,1,402,3428
ARTime,reward_low_FP_rate,artificialWithAnomaly/art_daily_jumpsup.csv,0.317585,0.8589086704377245,1,3025,0,402,3428
ARTime,reward_low_FP_rate,artificialWithAnomaly/art_load_balancer_spikes.csv,0.317585,-0.8306167175194854,2,3017,8,401,3428
ARTime,reward_low_FP_rate,artificialWithAnomaly/art_daily_jumpsdown.csv,0.317585,0.8589086704377245,1,3025,0,402,3428
ARTime,reward_low_FP_rate,artificialWithAnomaly/art_daily_nojump.csv,0.317585,-1.22,0,3024,1,403,3428
ARTime,reward_low_FP_rate,realTraffic/speed_7578.csv,0.317585,2.6685955363952827,7,838,4,109,958
ARTime,reward_low_FP_rate,realTraffic/TravelTime_387.csv,0.317585,1.6211080124592978,5,1872,4,244,2125
ARTime,reward_low_FP_rate,realTraffic/speed_t4013.csv,0.317585,1.5044604483793382,4,1870,1,246,2121
ARTime,reward_low_FP_rate,realTraffic/occupancy_t4013.csv,0.317585,1.5044604483793382,2,1874,1,248,2125
ARTime,reward_low_FP_rate,realTraffic/speed_6005.csv,0.317585,0.8393187159363497,1,1886,0,238,2125
ARTime,reward_low_FP_rate,realTraffic/TravelTime_451.csv,0.317585,0.8548083738085046,1,1621,0,216,1838
ARTime,reward_low_FP_rate,realTraffic/occupancy_6005.csv,0.317585,-0.1601005964204687,2,1779,5,237,2023
ARTime,reward_low_FP_rate,realAdExchange/exchange-3_cpm_results.csv,0.317585,0.422311837585681,1,1153,2,152,1308
ARTime,reward_low_FP_rate,realAdExchange/exchange-2_cpc_results.csv,0.317585,0.202008051434177,1,1215,3,162,1381
ARTime,reward_low_FP_rate,realAdExchange/exchange-4_cpm_results.csv,0.317585,0.9275631391333488,3,1230,3,161,1397
ARTime,reward_low_FP_rate,realAdExchange/exchange-4_cpc_results.csv,0.317585,1.7166572758976146,3,1229,3,162,1397
ARTime,reward_low_FP_rate,realAdExchange/exchange-3_cpc_results.csv,0.317585,2.7007622427413946,3,1155,0,150,1308
ARTime,reward_low_FP_rate,realAdExchange/exchange-2_cpm_results.csv,0.317585,-0.14465135576188293,2,1219,0,160,1381
ARTime,reward_low_FP_rate,artificialNoAnomaly/art_daily_small_noise.csv,0.317585,0.0,0,3428,0,0,3428
ARTime,reward_low_FP_rate,artificialNoAnomaly/art_daily_no_noise.csv,0.317585,-0.22,0,3427,1,0,3428
ARTime,reward_low_FP_rate,artificialNoAnomaly/art_flatline.csv,0.317585,0.0,0,3428,0,0,3428
ARTime,reward_low_FP_rate,artificialNoAnomaly/art_daily_perfect_square_wave.csv,0.317585,0.0,0,3428,0,0,3428
ARTime,reward_low_FP_rate,artificialNoAnomaly/art_noisy.csv,0.317585,0.0,0,3428,0,0,3428
ARTime,reward_low_FP_rate,realAWSCloudwatch/ec2_cpu_utilization_825cc2.csv,0.317585,0.6850457149420563,3,3083,2,340,3428
ARTime,reward_low_FP_rate,realAWSCloudwatch/ec2_cpu_utilization_fe7f93.csv,0.317585,-1.3223779892505907,3,3014,9,402,3428
ARTime,reward_low_FP_rate,realAWSCloudwatch/ec2_cpu_utilization_53ea38.csv,0.317585,-0.04175767720246226,3,3022,4,399,3428
ARTime,reward_low_FP_rate,realAWSCloudwatch/ec2_cpu_utilization_c6585a.csv,0.317585,-0.22,0,3427,1,0,3428
ARTime,reward_low_FP_rate,realAWSCloudwatch/ec2_network_in_257a54.csv,0.317585,0.679893811480864,1,3024,1,402,3428
ARTime,reward_low_FP_rate,realAWSCloudwatch/ec2_cpu_utilization_ac20cd.csv,0.317585,0.37755621870561307,2,3022,3,401,3428
ARTime,reward_low_FP_rate,realAWSCloudwatch/ec2_disk_write_bytes_c0d644.csv,0.317585,-0.3327782063433372,5,3017,6,400,3428
ARTime,reward_low_FP_rate,realAWSCloudwatch/grok_asg_anomaly.csv,0.317585,1.7906655830829998,4,3459,4,461,3928
ARTime,reward_low_FP_rate,realAWSCloudwatch/iio_us-east-1_i-a2eb1cd9_NetworkIn.csv,0.317585,-2.66,0,928,3,126,1057
ARTime,reward_low_FP_rate,realAWSCloudwatch/ec2_cpu_utilization_77c1ca.csv,0.317585,-0.4940553818938034,2,3018,7,401,3428
ARTime,reward_low_FP_rate,realAWSCloudwatch/rds_cpu_utilization_e47b3b.csv,0.317585,1.1143201258590167,3,3023,3,399,3428
ARTime,reward_low_FP_rate,realAWSCloudwatch/rds_cpu_utilization_cc0c53.csv,0.317585,1.2715235321219427,2,3024,2,400,3428
ARTime,reward_low_FP_rate,realAWSCloudwatch/ec2_network_in_5abac7.csv,0.317585,0.27055356254207175,3,3540,7,471,4021
ARTime,reward_low_FP_rate,realAWSCloudwatch/ec2_cpu_utilization_5f5533.csv,0.317585,1.6976723158532012,3,3026,0,399,3428
ARTime,reward_low_FP_rate,realAWSCloudwatch/elb_request_count_8c0756.csv,0.317585,1.0335913854419891,2,3023,3,400,3428
ARTime,reward_low_FP_rate,realAWSCloudwatch/ec2_cpu_utilization_24ae8d.csv,0.317585,1.5216790938898517,3,3025,1,399,3428
ARTime,reward_low_FP_rate,realAWSCloudwatch/ec2_disk_write_bytes_1ef3de.csv,0.317585,0.00348653030927637,2,3543,5,471,4021
Totals,,,,35.157280417015606,167,299131,216,33328,332842
